--------------------
--  -  - ?- -- --- -
--    -    -    -- -
- ---   - -  -- -- ?
-  -  --  -  +- -  ^
- ?-- --  --  - -  -
--      - -  -     -
-     -  - - -?-- +-
--  ---       - -  -
- *    ---  - - -  -
--  -      -     +--