--------------------
--  -  - ?- -- --- -
--    -    -    -- -
- ---   - -  -- -- +
-  -  --  -  +- -  ^
- ?-- --  --  - -  -
--      - -  -     -
-     -  - - -+-- ?-
--  ---       - -  -
- *    ---  - - -  -
--  -      -     ?--