--------------------
--  -  - ?- --+-   -
--   ?-^-  - ^  ?  -
-  --   ---  --    ?
-  +  -- +---?-    ?
- ?-- --  -- +-    -
--   -  ---+ -     -
-    ?- -- -  +-  +-
--  -   -     -    -
- *     --  - -    -
---+-  +   -- -  ? -
--  -  - ?- -- -   -
--   ?-^-   -+ +- +-
-  --  - +    -    -
-     -- +- - -    -
- ? ----   -- -    -
--      ---        -
^   ?- -- -  ^-    -
--  -   -    ?-    -
-------^+-----------
