--------------------
--  -  - ?- -- --- -
--    -    -    -- -
- ---   - -  -- -- +
-  -  --  -  ?- -  ^
- ?-- --  --  - -  -
--      - -  -     -
-     -  - - -+-- +-
--  ---       - -  -
- *    ---  - - -  -
--  -      -     ?--