--------------------
--  -  - +- -- --- -
--    -    -    -- -
- ---   - -  -- -- ?
-  -  --  -  ?- -  ^
- ?-- --  --  - -  -
--      - -  -     -
-     -  - - -+-- ?-
--  ---       - -  -
- *    ---  - - -  -
--  -      -     +--