--------------------
--  -  - +- -- --- -
--    -    -    -- -
- ---   - -  -- -- ?
-  -  --  -  +- -  ^
- ?-- --  --  - -  -
--      - -  -     -
-     -  - - -?-- ?-
--  ---       - -  -
- *    ---  - - -  -
--  -      -     +--